R 500 500
NO ./textures/wall_4.xpm
SO ./textures/wall_3.xpm
WE ./textures/wall_2.xpm
EA ./textures/wall_1.xpm
S ./textures/sprite_1.xpm
F 220,100,0
C 225,30,0
1111111111111111111111111
1000000000110000000000001
1011000001110000002000001
1001000000000000000000001
1111111110010000011100001
1000000000010000011101111
1111011111000001110000001
1111011111000001110101001
1100000011010101110000001
1000200000000000110000001
1000000000000000110101001
1100000111010101111101111
11110111 1110101 10111101
11111111 1111111 11111111
