R 1920 1080

NO ./textures/wall_4.xpm

SO ./textures/wall_3.xpm

WE ./textures/wall_2.xpm


EA ./textures/wall_1.xpm
S ./textures/sprite_1.xpm

F 220,100,0



C 225,30,0
1111111111111111111111111
1000000000110000000000001
1011000001110000002000001
10010000000000000000000011111
11111111100100000111000000001
10000000000100000111011100001
11110111110000011100000011111
1111011111000001110101001
1100000011010101110000001
1000200000000000110000001
1000000000000000110101001
1100000111010101111101111
11110111 1110101 10111101
11111111 1111111 11111111


