R 1000 720

NO ./textures/wall_4.xpm

SO ./textures/wall_3.xpm

WE ./textures/wall_2.xpm


EA ./textures/wall_1.xpm
S ./textures/sprite_1.xpm

F 197,180,162



C 80,188,223



             111
             101
1111111111111101111111111
1000000000110000000001001
1011000001110000002001111
1001000000000000000000001111111111111111
1111111110010000011100000000000000000001
100000000001000001110111000000000000S001
1111011111000001110000001111111111111111
1111011111000001110101001
1100000011010101110000001
1000200000000000110000001
1000000000000000110101001
1100000111010101110101101
11110111 1110101 10111101
11111111 1111111 11111111


