R 1000 500

NO ./textures/wall_4.xpm

SO ./textures/wall_3.xpm

WE ./textures/wall_2.xpm


EA ./textures/wall_1.xpm
S ./textures/sprite_1.xpm

F 197,180,162



C 80,188,223


11111111111111111111111111111111111111
1000E000000000000000000000000000000001
11111111111111111111111111111111111111

