R 1920 1080

NO ./textures/innovationacademy.xpm

SO ./textures/zingzinge.xpm

WE ./textures/apple.xpm


EA ./textures/minianz.xpm
S ./textures/notebook.xpm

F 197,180,162



C 80,188,223


             111
             101
1111111111111101111111111
1000000000110000000001001
1011000001110000002001111
10010000000000000000000011111
11111111100100000111000000001
10000000000100000111011100001
11110111110000011100000011111
1111011111000001110101001
1100000011010101110000001
10002000000000001100S0001
1000000000000000110101001
1100000111010101110101101
11110111 1110101 10111101
11111111 1111111 11111111
