R 840 480

NO ./textures/wall_4.xpm

SO ./textures/wall_3.xpm

WE ./textures/wall_2.xpm


EA ./textures/wall_1.xpm
S ./textures/sprite_1.xpm

F 197,180,162



C 80,188,223


1111111111111111111111111111111111111111111111111111111111111111
1111111000111111111111111111111111111111111111111111111111111111
11111100S0011111111111111111111111111111111111111111111111111111
1111100000001111111111111111111111111111111111111111111111111111
1111000010000110000000000000001111111111111111111111111111111111
1110000111000000101010101010100000011111111111111111111111111111
1111000010000110000000000000001111011111111111111111111111111111
1111100000001111111111111111111111011111111111111111111111111111
1111110000011111111111111111111111011111111111111111111111111111
1111111000111111111111111111111111011111111111111111111111111111
1111111101111111111111111111111111011111111111111111111111111111
1111111111111111111111111111111111011111111111111111111111111111
1111111111111111111111111111111111011111111111111111111111111111
1111111111111111111111111111111111000000000000000000000000000001
1111111111111111111111111111111111000000000000000000000000000001
1111111111111111111111111111111111111111111111111111111111111101
1111111111111111111111111111111111111111111111111111111111111101
1111111111111111111111111111111111111111111111111111111111111101
1111111111111111111111111111111111111111111111111111111111111101
1111111111111111111111111111111111111111111111111111111111111101
1111111111111111111111111111111111111111111111111111111111111101
1111111111111111111111111111111111111111111111111111111111111101
1111111111111111111111111111111111111111111111111111111111111101
1111111111111111111111111111111111111111111111111111111111111101
1111111111111111111111111111111111111111111111111111111111111101
1111111111111111111111111111111111111111111111111111111111111101
1111111111111111111111111111111111111111111111111111111111111101
1111111111111111111111111111111111111111111111111111111111111101
1111111111111111111111111111111111111111111111111111111111111101
1111111111111111111111111111111111111111111111110111111101111101
1111111111111111111111111111111111111111111111100011111000111101
1111111111111111111111111111111111111111111110000001110000011101
1111111111111111111111111111111111111111111111000000100000000001
1111111111111111111111111111111111111111111111100000000000011111
1111111111111111111111111111111111111111111111110001111000111111
1111111111111111111111111111111111111111111111111011111101111111
1111111111111111111111111111111111111111111111111011111101111111
1111111111111111111111111111111111111111111111111011111101111111
1111111111111111111111111111111111111111111111111011111101111111
1111111111111111111111111000000000001111111111111011111101111111
1111111111111111111111111011111111111111111111111011111101111111
1111111111111111111111111011111111111111111111111011111101111111
1111111111111111111111111011111111111111111111111011111101111111
1111111111111111111111111011101000000000111111111000000000001111
1111111111111111111111111011101000000000111111111011111110001111
1111111111111111111111111011101000111000111111111010000010101111
1111111111111111111111111011101000111000000000000010000000001111
1111111111111111111111111011101000000000111111111010000010101111
1111111111111111111111111011101000000000111111111011111110001111
1111111111111111111111111011101000111000000000000000000000101111
1111111111111111111111111011101000111000111111111110000000001111
1111111111111111111111111011101000000000111111111110000000101111
1111111111111111111111111011101000000000000000000000111110001111
1111111111111111111111111011101000111000111111100011111110101111
1111111111111111111111111011101000111000111111111111111110001111
1111111111111111111111111011101000000000000000000000000000101111
1111111111111111111111111011101000000000111111111110111110001111
1111111111111111111111111011101000111000111111111110000000101111
1111111111111111111111111000001000111000111111111111111110001111
1111111111111111111111111000000000000000000000000000000000101111
1111111111111111111111111111111000000000111111111111111110001111
1111111111111111111111111111111111110000111111111111111110101111
1111111111111111111111111111111111110000000000000000000000001111
1111111111111111111111111111111111111111111111111111111111111111
